FFFFFFFFFFFFFFFNNNFF
FFFFFFFFFFFFFFNNNNFF
FFFFFFNNNFFFFFFFNNFF
FFFFFNNNFFFFFFFFFNFF
FFFFFFNNFFFFFFFFFFFF
FFFFFFFFFFFNNNNNFFFF
FFFFFFFFFNNNNFNNNNFF
FFFFFFFFFFNNNNNNNNNF
FFFFFFFFFFFFNNNNNNFF
FFFFFFFFFFFFFFNNNFFF
FFFFFFFFFFFFFFFFFFFF
FFFFFFFFFFFFFFFFFFFF
FFFFFFFFFFFFFFFFFFFF
FFFFFNNNNNNNNNFFFFFF
FFNNNNNNNNNNNNNNNFFF
FFFNNNNNNNNNNNNNNNNN
NNNNNNNNNNNNNNNNFFFF
NNNNNNNNNNNNFFFFFFFF
FFFFNNNNNNFFFFFFFFFF
FFFFFFFFFFFFFFFFFFFF
